#####################
#.........#.........#
#!###.###.#.###.###!#
#.###.###.#.###.###.#
#...................#
#.###.#.#####.#.###.#
#.....#...#...#.....#
#####.###.#.###.#####
____#.#.......#.#____
#####.#.##-##.#.#####
@.......#---#.......@
#####.#.#####.#.#####
____#.#.......#.#____
#####.#.#####.#.#####
#.........#.........#
#.###.###.#.###.###.#
#!..#...........#..!#
###.#.#.#####.#.#.###
#.....#...#...#.....#
#.#######.#.#######.#
#...................#
#####################